WWWWXLLLLLLLWWWWLLLLLLLLLLLLPPXR
WWWWrLLLLLLLWLLWLLLLLLLLLLLLPPrR
AAAWrLLLLLLLWLLWLLLLLLLLLLLLPPrW
AWWWrLLLLLLLWWWWLRRRRRRLLLLLPPrW
AWWWrrrrrrrLLLLLLrrrrrrrrrrrrrrW
AWWWrRWWLRrrrrrrrrWWWWWWrLLLWWWW
AAAArRWWLRrLWWWWLrAAAAAArLLWWWWW
AAAArRWWLRrLLWWWLrWWWWAArLWWWWWW
NrrrrRWWLRrLLLWWLrWWWAAWrWWWWWWW
PrLLrRWWLRrLWLLWLrWWAAWWrAAAAAAA
PrLLrRWWLRrLWWLLLrWAAWWWrAAAAAAA
PrLLrRWWLLrLWWWLLrAAWWWWrAAALLLL
PrLLrRWWLLrLWWWWLrAAAAAArAAALLLL
PrrrrRWWLLrPPPPPPrWWWWWWrAAALLLL
LLLLrRWWLLrPPPPPPrWWWWWWrAAALLLL
LLLLrRWWLLrPPPPPPrWWWWWWrAAALLLL
LLLLrRWWLLrrrrrrrrWWWrrrrrrrrrrN
LLLLrRWWAAPPRRRRPPWWWrAAAAARRRRR
LLLLrRWWAALLLLLLLLWWWrAAAAAAAAAA
LLLLrRWWAALLLLLLLLWWWrAAAAAAAAAA
LLLLrRWWAALLLLWWWLWWWrAAAAAAAAAA
LLLLrrrrAALLLLWWWLWWWrAAAAAAAAAA
LLLLLLLrAAAAAAWWWrrrrrAAAAAAAAAA
LLLALALrAAAAAAAAArLLLLLLPPPAAAAA
LLAAAAArrrrrrrrrrrLLLLLLPPPAAAAA
LLLAAALrLLLLLLLLLrLLLLLLPPPAAAAA
LLLLALLrLLLLLLLLLrLLLLLLPPPAAAAA
LLLLLLLrPPPLLLLLLrrrrrrrrrrAAAAA
LLLLLLLrrrRLLLLLLWWWWWWWWWrAAAAA
LWWWWWWWWrRLLLLLLWWWWWWWWWrAAAAA
LWWWWWWWWrRLLLLLLWWrrrrrrrrAAAAA
LWWWWWWWWrRLLLLLLWWrPPPPPPPAAAAA
LLLLLLLLLNRLLLLLLWWXPPPPPPPAAAAA